NO textures/hexagonwall.xpm
SO textures/blackhexagon.xpm
WE textures/spaceship.xpm
EA textures/spaceshipdark.xpm




C 1                   ,                              8,                                         255            


F       1                         ,           1          ,      100











111
111
111
 11111111111111111111111111
11111111111111111111111111
1111111E1111111111111111111
11111111111111111111111111
11111111111111111111111111
11111111111111111111111111
111111111111111111111111111
11111111111111111111111111 1
11111111111111111111111111  1111
11111111111111111111111111  1
11111111111111111111111111    1
11111111111111111111111111     1
111111111111111111111111111    11
111111111111111111111111111111111
11111111111111111111111111111011111
111111111111th1111111111111111111101
11111111111111111111111111111111111
11111111111111111111111111
11111111111111111111111111
11111111111111111111111111
111111111111111111111111
111111111111111111111111111111111111111111111111111111111111111111111111111111111111111111111111111111111111111111111111111
11111111111111111111111111
11111111111111111111111111
11111111111111111111111111
11111111111111111111111111
111111111111111111111111111
