SO textures/walls/purple.xpm
WE textures/walls/red.xpm
NO textures/walls/blue.xpm
EA textures/walls/gold.xpm

F 0             ,        25       ,      45          
C   30                       ,           40             ,        70      

11111111111111111111111111111111111111111111111111111111111111111111111111
1000000000110000000000001
1011000001110000000000001
1001000000000000000000001
1111111110110000011100001
1000000000110000011101111
1000000000110000011101111
1000000000110000011101111
1000000000110000011101111
1000000000110000011101111
1000000000110000011101111
100000000011000001110111111111111111111111111
1000000000110000011101111
1000000000110000011101111
1000000000110000011101111
1000000000110000011101111
1000000000110000011101111
1000000000110000011101111
1000000000110000011101111
1000000000110000011101111
1000000000110000011101111
1000000000110000011101111
1000000000110000011101111
1000000000110000011101111
1000000000110000011101111
1000000000110000011101111
1000000000110000011101111
1000000000110000011101111
1000000000110000011101111
1000000000110000011101111
1000000000110000011101111
1000000000110000011101111
1000000000110000011101111
1000000000110000011101111
1000000000110000011101111
1000000000110000011101111
1000000000110000011101111
1000000000110000011101111
1000000000110000011101111
1000000000110000011101111
1000000000110000011101111
1000000000110000011101111
1000000000110000011101111
1000000000110000011101111
1000000000110000011101111
1000000000110000011101111
1000000000110000011101111
1000000000110000011101111
1000000000110000011101111
1000000000110000011101111
1000000000110000011101111
1000000000110000011101111
1000000000110000011101111
1000000000110000011101111
1000000000110000011101111
1000000000110000011101111
1000000000110000011101111
1000000000110000011101111
1000000000110000011101111
1000000000110000011101111
1000000000110000011101111
1000000000110000011101111
1000000000110000011101111
1000000000110000011101111
1000000000110000011101111
1000000000110000011101111
1000000000110000011101111
1000000000110000011101111
1000000000110000011101111
1000000000110000011101111
1000000000110000011101111
1000000000110000011101111
1000000000110000011101111
1000000000110000011101111
1000000000110000011101111
1000000000110000011101111
1000000000110000011101111
1000000000110000011101111
1000000000110000011101111
1000000000110000011101111
1000000000110000011101111
1000000000110000011101111
1000000000110000011101111
1000000000110000011101111
1000000000110000011101111
1000000000110000011101111
1000000000110000011101111
1000000000110000011101111
1000000000110000011101111
1000000000110000011101111
1000000000110000011101111
1000000000110000011101111
1000000000110000011101111111111111111111111111111111111111111111111
1000000000110000011101111
1000000000110000011101111
1000000000110000011101111
1000000000110000011101111
1000000000110000011101111
1000000000110000011101111
1000000000110000011101111
1000000000110000011101111
1000000000110000011101111
1000000000110000011101111
1000000000110000011101111
1000000000110000011101111
1000000000110000011101111
1000000000110000011101111
1000000000110000011101111
1000000000110000011101111
1000000000110000011101111
1000000000110000011101111
1000000000110000011101111
1000000000110000011101111
1000000000110000011101111
1000000000110000011101111
1000000000110000011101111
1000000000110000011101111
1000000000110000011101111
1000000000110000011101111
1000000000110000011101111
1000000000110000011101111
1000000000110000011101111
1000000000110000011101111
1000000000110000011101111
1000000000110000011101111
1000000000110000011101111
1000000000110000011101111
1000000000110000011101111
1000000000110000011101111
1000000000110000011101111
1000000000110000011101111
1000000000110000011101111
1000000000110000011101111
1000000000110000011101111
1000000000110000011101111
1000000000110000011101111
1000000000110000011101111
1000000000110000011101111
1000000000110000011101111
1000000000110000011101111
1000000000110000011101111
1000000000110000011101111
1000000000110000011101111
1000000000110000011101111
1000000000110000011101111
1000000000110000011101111
1000000000110000011101111
1000000000110000011101111
1000000000110000011101111
1000000000110000011101111
1000000000110000011101111
1000000000110000011101111
1000000000110000011101111
1000000000110000011101111
1000000000110000011101111
1000000000110000011101111
1000000000110000011101111
1000000000110000011101111
1000000000110000011101111
1000000000110000011101111
1000000000110000011101111
1000000000110000011101111
1000000000110000011101111
1000000000110000011101111
1000000000110000011101111
1000000000110000011101111
1000000000110000011101111
1000000000110000011101111
1000000000110000011101111
1000000000110000011101111
1000000000110000011101111
1000000000110000011101111
1000000000110000011101111
1000000000110000011101111
1000000000110000011101111
1000000000110000011101111
1000000000110000011101111
1000000000110000011101111
1000000000110000011101111
1000000000110000011101111
1000000000110000011101111
1000000000110000011101111
1000000000110000011101111
1000000000110000011101111
1000000000110000011101111
1000000000110000011101111
1000000000110000011101111
1000000000110000011101111
111101111111110111000000111111111111111111111111111111111111111111111111111
1111011111111101110101001
11000000110101011100N0001
1000000000000000110000001
1000000000000000110101001
1100000111010101111101111
1111111111111111111111111
